11 11
S#########X
####T##X##W
#M#####X###
#######X###
####XXXX##D
#X#########
#X######C#F
#XXX##F###G
###########
######B####
#####MMM###